=== Départ ➢ #  # ============
##############  ##############
#           ##               #
#     M                      #
#               ###########  #
#  ###############           #
#                     M      #
#    M                       #
#########  ################  #
#          ##   P   #######  #
#          ##       #######  #
#  ##########       ##       #
#          ##   M   ##   M   #
#   M      ##o      ##       #
#########  ####  #####o  ##  #
#o           ##  ##########  #
#      M     ##  ##          #
#  ############  ##   ########
#            ##  ##          #
#  M             ## o #### o #
##############################