=== Départ ➢ #  # ============
##############  ##############
#           ##               #
#     ♘     ##               #
#                ##########  #
#  #################         #
#                     ♘      #
#######  ###########      ####
#     #    ###########       #
#  ♘  ###  ##   ₱   ##       #
#          ##       ######   #
#  ##########       ##       #
#          ##   ♘   ##   ♘   #
#########  ##☯      ##       #
#########  ####   ####☯  #   #
#      #     ##   ########   #
#      #  ♘  ##   #          #
#  #☯        ##   #   #####  #
#  ############   #   ####   #
#                 # ☯ #### ☯ #
##############################